5 5 5 5 5 5 5 5 5 5 5 5 5 5 5 5 5 5
5 1 0 1 0 1 0 1 0 1 0 1 0 1 0 1 0 5
5 1 0 1 0 1 3 1 0 1 0 1 0 1 0 1 0 5
5 1 0 1 0 1 0 1 0 1 0 1 0 1 0 1 0 5
5 1 2 1 0 1 3 1 0 1 0 1 0 1 0 1 0 5
5 1 0 1 0 1 0 1 0 1 0 1 0 1 0 1 0 5
5 1 0 1 0 1 0 1 0 1 0 1 0 1 0 1 0 5
5 1 0 1 0 1 0 1 0 1 0 1 0 1 0 1 0 5
5 1 0 1 0 1 0 1 0 1 0 1 0 1 0 1 0 5
5 1 0 1 0 1 0 1 0 1 0 1 0 1 0 1 0 5
5 1 0 1 0 1 0 1 0 1 0 1 0 1 0 1 0 5
5 1 0 1 0 1 0 1 0 1 0 1 0 1 0 1 0 5
5 1 0 1 0 1 0 1 0 1 0 1 0 1 0 1 0 5
5 5 5 5 5 5 5 5 5 5 5 5 5 5 5 5 5 5